//country=Alias
ANTIGUA AND BARBUDA=ANTIGUA,BARBUDA
PLURINATIONAL STATE OF BOLIVIA=BOLIVIA
BONAIRE SINT EUSTATIUS AND SABA=SABA,ST. EUSTATIUS
BOSNIA AND HERZEGOVINA=BOSNIA-HERZEGOVINA
CAYMAN ISLANDS=CAYMAN ISLES
CHINA=TIBET
CHRISTMAS ISLAND=CHRISTMAS ISLE
CONGO=BRAZZAVILLE
THE DEMOCRATIC REPUBLIC OF THE CONGO=ZAIRE
COCOS ISLANDS=KEELING
COTE D'IVOIRE=IVORY COAST
FALKLAND ISLANDS=MALVINAS
FAROE ISLANDS=FAROE ISLE
FRANCE=FRENCH WEST INDIES
FRENCH POLYNESIA=TAHITI
FRENCH SOUTHERN TERRITORIES=FRENCH SOUTHERN ATLANTIC TERRITORY
HOLY SEE (VATICAN CITY STATE)=VATICAN CITY
ISLAMIC REPUBLIC OF IRAN=IRAN
IRELAND=REPUBLIC OF IRELAND
KIRIBATI=GILBERT ISLANDS
DEMOCRATIC PEOPLE'S REPUBLIC OF KOREA=KOREA NORTH 
REPUBLIC OF KOREA=KOREA SOUTH
KYRGYZSTAN=KYRGYSTAN
LAO PEOPLE'S DEMOCRATIC REPUBLIC=LAOS
MACAO=MACAU
THE FORMER YUGOSLAV REPUBLIC OF MACEDONIA=MACEDONIA
FEDERATED STATES OF MICRONESIA=MICRONESIA
REPUBLIC OF MOLDOVA=MOLDOVA
MYANMAR=BURMA
NAURU=NAURU ISLE
NETHERLANDS=NETHERLANDS ANTILLES
NORFOLK ISLAND=NORFOLK ISLE
PALAU=BELAU
STATE OF PALESTINE=PALESTINE
PITCAIRN=PITCAIRN ISLES
PORTUGAL=AZORES
REUNION=REUNION ISLES
RUSSIAN FEDERATION=RUSSIA
SAINT HELENA ASCENSION AND TRISTAN DA CUNHA=ST HELENA,ASCENSION ISLE,TRISTAN DA CUNHA
SAINT KITTS AND NEVIS=ST KITTS & NEVIS
SAINT LUCIA=ST LUCIA
SAINT MARTIN (FRENCH PART)=ST MARTIN
SAINT VINCENT AND THE GRENADINES=ST VINCENT & GRENADINES
SAMOA=WESTERN SAMOA
SINT MAARTEN (DUTCH PART)=SINT MAARTEN
SOLOMON ISLANDS=SOLOMON ISLES
SOUTH GEORGIA AND THE SOUTH SANDWICH ISLANDS=SOUTH GEORGIA
SPAIN=MELLILA,CEUTA,MADEIRA,CANARY ISLES,BALEARIC ISLES
SURINAME=SURINAM
SYRIAN ARAB REPUBLIC=SYRIA
PROVINCE OF CHINA TAIWAN=TAIWAN
UNITED REPUBLIC OF TANZANIA=TANZANIA
TIMOR-LESTE=EAST TIMOR
TRINIDAD AND TOBAGO=TRINIDAD & TOBAGO
TURKS AND CAICOS ISLANDS=TURKS & CAICOS ISLES
UNITED ARAB EMIRATES=UAE
UNITED STATES=USA,HAWAII
BOLIVARIAN REPUBLIC OF VENEZUELA=VENEZUELA
VIET NAM=VIETNAM
BRITISH VIRGIN ISLANDS=VIRGIN ISLES UK
US VIRGIN ISLANDS=VIRGIN ISLES USA,U S VIRGIN ISLANDS
WALLIS AND FUTUNA=WALLIS & FUTUNA ISLES
